10
+--+--+--+--+--+--+--+--+--+--+
   |  |        |              |
+  +  +--+  +--+--+  +  +--+--+
|  |  |     |        |        |
+  +  +--+  +--+  +  +--+--+--+
|                 |     |  |  |
+--+  +  +--+--+--+  +--+  +  +
|  |  |     |              |  |
+  +--+--+--+  +--+  +--+  +  +
|     |     |     |  |  |  |  |
+  +--+--+  +  +--+--+  +  +  +
|        |     |        |     |
+--+  +  +--+  +--+  +--+  +  +
|     |     |        |     |  |
+--+  +  +--+--+--+  +--+  +  +
|  |  |  |        |  |     |  |
+  +  +--+  +  +--+  +--+--+--+
|           |        |     |  |
+  +  +  +  +--+  +  +  +  +  +
|  |  |  |  |     |     |      
+--+--+--+--+--+--+--+--+--+--+