20
+--+--+--+--+--+--+--+--+--+--+--+--+--+--+--+--+--+--+--+--+
   |  |           |           |        |  |     |  |        |
+  +  +--+  +--+  +  +--+  +--+  +--+  +  +  +--+  +--+  +--+
|           |           |  |        |     |        |        |
+--+  +  +--+--+--+--+--+  +--+  +--+  +--+--+  +--+--+  +  +
|  |  |  |        |     |  |  |  |           |  |        |  |
+  +--+  +  +--+  +  +--+--+  +--+  +--+--+--+  +--+  +--+--+
|     |     |  |           |     |           |        |     |
+  +  +  +--+  +--+  +--+  +  +--+  +  +  +--+  +--+--+  +--+
|  |     |  |     |  |  |  |        |  |        |           |
+--+--+  +  +--+  +--+  +  +  +--+--+--+--+--+  +--+  +--+  +
|        |  |  |        |  |        |        |     |     |  |
+--+--+  +  +  +  +--+  +--+--+--+  +--+  +--+  +--+--+  +  +
|     |           |        |        |        |  |        |  |
+  +  +--+  +--+--+--+  +--+  +--+  +--+--+  +  +  +--+  +--+
|  |  |        |     |  |  |  |  |  |        |        |     |
+--+  +--+  +  +  +--+  +  +  +  +--+--+--+  +  +--+--+--+  +
|        |  |     |  |              |     |  |     |  |  |  |
+  +  +  +  +--+  +  +--+--+--+--+--+  +--+  +--+--+  +  +  +
|  |  |     |  |  |  |  |              |     |  |  |  |     |
+--+--+--+  +  +  +  +  +--+  +--+--+--+--+  +  +  +  +--+  +
|     |  |  |              |           |  |     |           |
+--+  +  +  +--+--+--+  +  +  +--+  +--+  +  +--+  +--+--+--+
|                    |  |  |  |     |                       |
+  +--+  +  +--+  +  +--+  +  +--+--+--+--+  +--+  +--+--+--+
|  |  |  |  |     |  |     |                    |  |        |
+--+  +--+--+--+  +--+--+--+  +--+--+--+  +  +--+--+--+  +  +
|           |     |  |     |     |        |     |        |  |
+  +--+  +  +  +  +  +  +--+--+--+  +  +--+  +  +  +--+  +  +
|  |     |  |  |  |  |           |  |  |     |  |  |     |  |
+--+--+--+  +  +  +  +--+  +  +--+--+--+--+--+--+--+--+  +--+
|     |     |  |     |  |  |     |        |     |  |  |  |  |
+--+  +  +--+  +--+--+  +  +--+--+--+  +--+  +--+  +  +  +  +
|  |     |     |     |        |     |                       |
+  +--+  +  +  +  +  +  +  +--+  +--+--+--+  +--+--+--+  +--+
|        |  |     |     |  |  |     |        |        |     |
+--+  +  +--+--+--+  +--+  +  +  +  +--+  +  +  +--+  +  +--+
|     |  |        |     |        |        |     |  |  |     |
+  +  +  +--+  +--+  +--+  +--+  +--+  +--+--+  +  +--+--+  +
|  |  |              |     |     |     |                 |   
+--+--+--+--+--+--+--+--+--+--+--+--+--+--+--+--+--+--+--+--+