10
+--+--+--+--+--+--+--+--+--+--+
   |     |        |        |  |
+  +--+  +  +--+  +--+  +--+  +
|              |        |  |  |
+  +--+  +  +--+  +--+--+  +  +
|     |  |     |  |  |  |     |
+  +--+--+  +  +--+  +  +--+  +
|     |     |  |  |     |     |
+  +--+  +--+--+  +  +--+  +  +
|     |  |           |  |  |  |
+  +  +  +--+--+  +  +  +--+  +
|  |  |     |     |  |        |
+--+--+--+  +--+  +  +  +--+--+
|  |  |           |        |  |
+  +  +  +  +--+--+--+--+  +  +
|        |  |     |  |        |
+  +--+--+--+  +--+  +  +--+--+
|        |        |           |
+  +--+  +--+--+  +  +--+--+  +
|     |  |              |      
+--+--+--+--+--+--+--+--+--+--+