10
+--+--+--+--+--+--+--+--+--+--+
      |  |     |     |        |
+  +  +  +  +  +  +--+  +  +  +
|  |     |  |  |        |  |  |
+--+--+  +  +--+  +--+--+--+--+
|  |  |     |  |     |  |  |  |
+  +  +  +--+  +  +--+  +  +  +
|     |     |  |  |           |
+  +  +  +--+  +  +  +--+  +--+
|  |                    |  |  |
+--+--+  +--+  +  +  +  +  +  +
|  |     |  |  |  |  |  |  |  |
+  +  +--+  +  +  +--+--+  +  +
|  |  |        |  |        |  |
+  +--+  +--+  +  +--+  +--+  +
|           |  |     |  |     |
+  +  +--+  +--+  +--+  +  +--+
|  |  |        |  |  |        |
+  +--+  +  +--+  +  +--+  +--+
|  |     |  |        |         
+--+--+--+--+--+--+--+--+--+--+

