23
+--+--+--+--+--+--+--+--+--+--+--+--+--+--+--+--+--+--+--+--+--+--+--+
      |              |                       |     |  |  |  |        |
+  +  +--+--+--+--+  +--+  +  +--+  +--+  +--+  +--+  +  +  +  +--+  +
|  |  |  |  |     |     |  |  |  |     |  |  |  |     |        |  |  |
+  +--+  +  +  +--+  +--+--+--+  +  +  +--+  +  +  +  +--+  +  +  +--+
|     |        |     |           |  |  |  |     |  |     |  |        |
+--+  +  +--+  +--+  +  +--+  +--+  +--+  +  +  +  +--+--+--+--+--+  +
|        |  |              |        |        |     |  |        |  |  |
+  +--+--+  +  +--+--+--+  +  +  +--+--+--+--+  +--+  +  +--+--+  +  +
|  |        |        |  |  |  |        |        |  |     |           |
+--+  +  +  +  +--+--+  +  +--+  +--+--+--+  +--+  +--+  +  +--+--+  +
|     |  |        |        |     |  |  |  |  |           |     |     |
+--+--+--+--+--+  +--+  +--+--+--+  +  +  +  +--+  +--+  +--+--+  +  +
|     |  |     |  |        |  |  |  |        |  |  |     |  |     |  |
+--+  +  +--+  +  +--+  +  +  +  +  +--+  +--+  +  +--+--+  +--+--+  +
|        |  |  |     |  |  |              |  |  |        |     |     |
+  +--+--+  +  +  +--+  +--+--+--+  +--+--+  +  +  +--+--+  +--+  +  +
|                 |                    |  |  |     |     |  |     |  |
+--+  +--+  +  +--+--+--+  +  +--+--+--+  +  +  +  +  +--+  +  +--+  +
|     |     |  |     |     |  |  |  |     |     |     |     |  |     |
+--+--+  +  +--+  +  +  +--+--+  +  +  +--+--+--+  +--+  +--+  +  +--+
|  |     |  |     |     |     |        |              |     |  |     |
+  +--+--+--+  +  +--+  +  +--+--+  +  +  +--+--+  +--+  +--+--+--+  +
|              |  |           |     |  |  |  |        |  |     |  |  |
+--+--+  +--+  +--+  +--+  +  +--+--+  +--+  +--+  +  +  +--+  +  +  +
|        |  |  |     |     |     |        |     |  |  |  |  |  |     |
+  +  +--+  +--+  +--+  +--+  +  +--+--+  +--+  +--+  +  +  +  +  +--+
|  |  |  |        |     |     |        |           |                 |
+  +--+  +--+  +--+--+  +  +  +--+  +--+  +--+--+  +  +  +--+  +--+--+
|  |     |           |  |  |     |     |        |     |  |  |  |     |
+  +--+  +  +--+  +--+--+--+  +--+--+  +--+  +--+  +--+--+  +  +  +  +
|  |     |     |  |  |     |     |     |     |     |  |  |     |  |  |
+--+--+  +--+--+  +  +  +--+--+--+  +--+--+--+--+  +  +  +--+--+  +--+
|  |     |     |     |                    |              |  |        |
+  +  +--+--+  +  +  +--+--+  +--+--+  +  +  +--+--+  +--+  +--+  +  +
|  |        |     |  |        |     |  |           |           |  |  |
+  +  +  +--+--+--+--+  +--+  +  +--+--+  +--+--+  +  +--+  +--+  +  +
|     |  |           |  |     |  |     |  |     |  |  |  |     |  |  |
+--+--+  +  +--+--+  +  +--+  +  +--+  +--+--+  +  +  +  +--+  +--+  +
|  |     |     |  |        |  |  |           |     |        |        |
+  +--+  +  +--+  +  +  +--+  +  +--+--+--+  +--+  +--+  +--+--+  +  +
|              |     |     |  |  |  |  |     |        |  |  |  |  |  |
+  +--+--+--+  +--+--+  +--+--+  +  +  +--+  +  +--+  +--+  +  +  +--+
|  |        |     |        |  |  |           |     |  |     |        |
+  +  +--+--+--+--+  +  +--+  +  +--+--+  +  +  +--+  +--+  +--+--+  +
|        |           |  |                 |        |           |      
+--+--+--+--+--+--+--+--+--+--+--+--+--+--+--+--+--+--+--+--+--+--+--+