5
+--+--+--+--+--+
         |     |
+  +--+  +  +  +
|  |  |     |  |
+  +  +--+--+  +
|  |        |  |
+--+  +--+--+  +
|     |        |
+--+  +--+  +  +
|           |   
+--+--+--+--+--+
