50
+--+--+--+--+--+--+--+--+--+--+--+--+--+--+--+--+--+--+--+--+--+--+--+--+--+--+--+--+--+--+--+--+--+--+--+--+--+--+--+--+--+--+--+--+--+--+--+--+--+--+
   |  |  |        |     |  |        |  |              |        |  |        |           |     |        |              |           |  |              |  |
+  +  +  +--+  +--+  +--+  +--+  +  +  +--+--+--+--+  +  +--+  +  +--+  +  +--+  +  +--+  +--+  +--+  +--+  +--+--+  +--+--+--+  +  +--+--+--+--+  +  +
|     |              |  |        |  |  |  |     |        |  |  |        |  |     |  |     |  |  |     |     |     |  |           |           |        |
+  +--+  +--+  +--+  +  +--+--+  +--+  +  +--+  +--+--+  +  +--+  +--+--+--+  +--+--+--+  +  +--+  +  +--+  +  +--+  +  +  +--+--+  +  +  +  +  +--+--+
|  |     |  |     |        |  |  |     |  |        |        |              |     |  |  |  |  |     |  |        |  |  |  |           |  |  |           |
+  +  +  +  +--+  +--+--+  +  +  +  +  +  +  +--+--+--+  +  +  +  +  +--+--+  +  +  +  +  +  +--+  +  +  +  +--+  +--+  +  +--+--+  +--+--+  +  +  +--+
|  |  |  |     |  |  |              |  |  |  |  |     |  |  |  |  |     |     |     |     |     |  |     |     |  |     |  |        |        |  |  |  |
+  +--+--+--+  +  +  +  +  +--+  +  +  +  +  +  +--+  +--+  +--+  +  +--+  +--+--+--+--+  +  +--+--+  +  +--+  +  +--+--+  +--+--+--+  +--+  +  +--+  +
|        |           |  |  |  |  |  |        |  |     |        |  |  |           |  |     |     |     |     |        |     |              |  |  |     |
+--+--+  +--+--+--+--+  +--+  +--+  +--+--+  +  +--+  +--+--+  +  +--+--+  +  +--+  +  +--+--+  +  +--+--+--+  +  +--+  +--+--+  +--+--+  +  +--+  +--+
|  |        |  |  |        |     |  |     |     |     |  |              |  |  |  |  |  |  |  |  |  |  |  |     |        |  |  |  |     |  |  |     |  |
+  +--+  +  +  +  +--+  +--+  +  +  +  +--+  +--+--+  +  +  +--+--+  +--+--+  +  +  +  +  +  +  +  +  +  +--+--+--+--+--+  +  +--+--+  +  +  +--+  +  +
|     |  |  |     |  |        |  |  |           |     |  |  |  |     |           |     |        |  |  |  |                 |              |     |     |
+  +--+  +  +--+  +  +--+--+  +--+--+--+  +--+--+--+  +  +--+  +--+  +--+--+  +--+--+  +  +--+  +  +  +  +  +  +--+--+  +--+--+--+  +--+--+--+  +  +  +
|  |     |  |  |     |     |  |  |     |        |     |     |     |     |     |        |     |  |  |        |  |     |  |     |     |        |     |  |
+  +--+  +  +  +  +--+--+  +  +  +  +--+--+--+  +  +--+  +--+  +--+  +  +--+  +--+  +--+  +--+--+--+  +--+  +--+--+  +--+  +  +--+  +--+  +  +  +--+  +
|  |  |  |  |  |     |     |        |  |  |     |           |     |  |           |           |  |     |     |           |  |     |     |  |  |  |     |
+  +  +  +--+  +--+  +  +--+--+--+  +  +  +  +  +  +--+  +  +  +--+  +--+--+  +  +  +--+--+  +  +--+--+  +  +--+  +--+--+--+  +--+  +--+  +--+--+--+  +
|        |                          |     |  |     |     |           |  |     |        |              |  |        |              |  |     |     |  |  |
+  +  +--+  +  +--+--+--+  +--+--+  +--+  +  +--+  +--+--+  +--+--+--+  +--+--+  +--+  +  +--+--+  +  +--+  +--+--+  +--+--+--+--+  +  +--+  +--+  +  +
|  |  |     |  |        |     |  |  |  |     |     |  |     |  |              |     |  |        |  |                 |  |     |     |  |        |     |
+  +  +--+  +--+  +  +--+  +--+  +  +  +--+  +  +--+  +--+--+  +--+  +  +  +--+  +  +--+--+--+  +--+--+--+--+  +  +  +  +--+  +--+--+  +  +  +  +--+  +
|  |     |  |     |  |     |  |     |        |     |        |        |  |  |     |     |     |              |  |  |        |     |        |  |  |     |
+  +  +  +--+  +--+--+--+  +  +  +  +--+  +  +--+  +  +  +--+--+--+  +--+--+  +--+  +--+  +  +  +--+  +--+--+  +  +--+  +--+  +  +--+--+--+--+  +  +--+
|  |  |  |  |     |           |  |     |  |     |     |  |        |              |     |  |        |     |  |  |  |           |  |     |              |
+--+  +--+  +--+  +  +--+  +--+  +--+--+--+  +--+--+  +--+  +  +--+--+--+--+  +--+  +--+  +  +--+  +--+  +  +  +--+--+--+--+  +  +  +  +  +--+  +--+  +
|  |     |     |     |  |  |  |  |  |  |     |  |        |  |  |     |     |  |  |  |     |  |  |     |     |  |  |     |  |  |     |  |  |     |  |  |
+  +--+  +  +--+  +--+  +  +  +  +  +  +  +  +  +--+  +  +  +--+  +--+--+  +  +  +--+--+--+  +  +--+  +--+  +  +  +  +  +  +--+  +--+--+--+--+  +  +  +
|  |              |  |        |     |  |  |        |  |  |           |  |           |  |        |     |  |  |        |  |     |        |     |     |  |
+  +--+--+--+  +--+  +  +--+--+--+--+  +--+--+  +  +  +  +  +--+--+--+  +--+--+--+--+  +--+  +--+  +--+  +  +--+  +--+--+  +  +  +--+--+  +  +--+--+  +
|     |     |        |  |     |        |        |  |  |  |  |        |  |  |  |     |     |  |  |        |  |  |  |     |  |        |     |  |  |     |
+--+  +--+  +  +  +--+  +  +--+  +--+--+--+  +--+--+--+  +  +  +--+--+  +  +  +--+  +  +--+  +  +--+  +--+--+  +  +  +--+--+  +--+--+  +--+--+  +  +--+
|        |     |  |  |  |                       |     |     |     |     |        |                 |           |        |  |  |  |  |     |  |        |
+  +--+  +  +--+  +  +--+--+  +  +--+--+  +--+--+  +--+  +  +  +  +--+  +--+  +  +--+--+  +  +  +--+--+  +--+  +--+--+  +  +--+  +  +--+  +  +  +--+  +
|     |     |     |           |  |  |     |              |     |              |  |     |  |  |        |     |  |     |     |              |  |  |     |
+  +--+  +--+--+  +--+  +--+--+  +  +--+  +  +  +  +  +--+  +--+--+--+--+--+  +--+--+  +  +--+  +--+--+  +--+--+  +--+  +  +  +--+--+--+--+  +  +--+--+
|     |     |     |  |     |  |  |  |     |  |  |  |  |           |           |        |  |     |     |  |  |  |        |                          |  |
+--+--+--+  +--+--+  +  +--+  +  +  +  +--+--+--+  +--+  +  +--+--+--+--+  +  +--+--+  +  +  +--+--+  +  +  +  +--+  +--+--+  +--+--+--+  +--+--+--+  +
|  |  |  |     |           |        |  |     |        |  |  |        |  |  |           |  |     |        |     |     |              |     |           |
+  +  +  +  +--+--+  +--+--+--+--+  +--+  +--+  +--+  +--+--+  +--+--+  +--+  +--+--+  +--+  +--+--+--+--+  +  +--+--+--+  +--+  +--+  +  +  +  +--+  +
|  |  |  |  |     |  |     |  |        |        |  |  |                 |        |     |     |  |        |  |  |  |     |     |  |     |     |  |     |
+  +  +  +--+--+  +  +  +--+  +--+--+--+--+  +  +  +  +--+--+--+--+  +  +  +--+--+  +  +  +  +  +  +  +  +  +  +  +--+  +--+  +--+--+  +--+--+  +--+--+
|                 |  |  |     |  |           |     |  |           |  |  |        |  |  |  |  |     |  |     |     |  |  |     |              |  |     |
+  +--+--+--+  +--+  +  +  +  +  +--+  +--+--+--+--+--+  +  +  +--+  +  +  +  +--+--+--+  +  +--+  +--+--+  +--+  +  +  +  +--+--+  +  +--+--+  +--+  +
|     |     |  |     |     |  |           |        |  |  |  |     |  |     |     |     |  |  |  |     |     |     |  |           |  |  |        |     |
+  +  +--+  +  +--+  +  +--+--+  +--+--+--+--+--+  +  +--+  +--+  +--+--+--+--+  +  +--+  +  +  +  +  +--+  +--+--+  +  +  +--+--+--+  +  +--+--+--+  +
|  |  |                    |     |        |  |           |  |                 |     |     |  |     |  |     |     |     |           |  |  |  |  |     |
+--+--+--+  +--+--+--+--+  +--+  +--+  +--+  +--+--+--+  +  +--+  +--+  +  +  +--+  +  +  +--+--+  +--+  +  +--+  +  +--+--+--+  +--+--+--+  +  +  +--+
|           |  |           |  |                 |        |  |  |     |  |  |  |     |  |              |  |     |     |  |  |     |           |        |
+  +  +--+  +  +--+  +  +  +  +--+--+--+  +--+--+  +--+  +--+  +--+  +--+  +--+  +--+  +--+--+  +--+--+  +--+--+--+--+  +  +--+  +  +--+--+  +  +--+  +
|  |  |        |  |  |  |  |  |     |  |        |     |     |  |        |  |        |  |        |           |     |        |  |  |  |              |  |
+--+--+  +--+--+  +  +--+--+  +  +--+  +  +--+  +  +--+  +--+  +  +  +  +  +--+--+--+  +--+--+--+  +  +--+--+  +  +--+  +--+  +--+  +--+  +--+--+  +--+
|  |     |  |        |  |  |           |  |        |        |  |  |  |  |     |  |  |           |  |        |  |  |  |        |  |  |     |           |
+  +  +  +  +  +--+  +  +  +--+--+--+  +--+--+  +  +--+  +--+  +--+  +--+  +--+  +  +  +  +--+  +--+--+--+--+  +--+  +--+--+  +  +--+  +  +--+  +--+--+
|     |     |     |  |              |        |  |  |     |        |  |              |  |     |                       |  |  |        |  |  |           |
+--+  +--+--+  +  +--+--+--+--+  +--+  +--+  +--+--+--+--+--+  +--+  +--+  +--+--+--+  +--+--+  +--+--+  +--+--+--+  +  +  +--+--+  +  +  +--+--+--+  +
|     |        |              |     |     |     |        |     |     |                 |        |     |  |                 |  |  |     |           |  |
+--+--+  +  +--+--+  +--+--+  +  +  +  +--+  +--+--+--+  +--+  +--+  +  +  +--+--+  +--+--+--+--+  +--+  +  +  +--+  +  +--+  +  +--+  +--+  +  +--+  +
|        |  |  |        |  |  |  |        |  |        |           |  |  |     |     |     |  |  |  |     |  |     |  |                    |  |  |     |
+  +--+--+--+  +--+  +--+  +--+--+  +  +--+--+  +  +  +  +--+  +--+--+--+  +--+--+--+  +--+  +  +  +--+  +--+  +  +--+  +--+--+--+--+--+  +--+  +--+  +
|        |  |  |  |           |     |  |  |     |  |  |     |  |                 |  |     |  |  |        |     |     |              |        |  |     |
+--+--+  +  +  +  +  +--+--+  +--+  +  +  +  +--+--+  +--+  +--+--+  +  +  +--+--+  +--+  +  +  +  +--+  +--+--+--+--+--+  +  +--+--+  +--+--+--+--+--+
|  |           |        |  |     |  |              |     |        |  |  |                 |     |     |        |     |  |  |     |        |           |
+  +  +--+  +  +  +--+  +  +--+  +  +--+  +  +--+--+--+  +--+  +--+  +--+  +--+  +--+  +--+  +--+  +--+--+--+  +--+  +  +--+  +--+--+--+  +--+  +  +--+
|     |     |  |     |     |        |     |  |        |     |        |  |     |     |           |  |  |     |           |  |        |     |     |     |
+--+  +--+  +  +  +--+--+--+--+--+--+--+--+--+  +--+--+  +  +--+  +--+  +  +--+--+  +--+--+--+  +  +  +--+  +  +  +--+  +  +  +  +--+--+--+  +--+--+  +
|        |  |  |  |        |     |     |                 |     |  |        |        |        |  |  |     |     |     |  |     |     |  |        |     |
+  +--+--+--+  +--+--+--+  +  +--+--+  +--+  +  +  +--+--+  +--+--+--+  +--+--+  +  +--+  +--+  +--+  +--+  +--+--+--+--+  +--+  +  +  +--+--+  +--+  +
|     |           |  |  |        |     |     |  |  |  |           |  |  |  |     |     |           |  |  |     |  |  |  |  |  |  |  |  |  |        |  |
+--+--+--+--+  +--+  +  +  +--+  +--+  +  +  +--+  +  +  +--+--+--+  +--+  +  +  +--+  +--+--+--+  +  +  +--+  +  +  +  +--+  +--+--+  +  +  +--+  +  +
|     |     |        |        |  |        |     |     |  |  |                 |  |           |  |  |     |     |  |  |        |           |  |     |  |
+  +--+--+  +--+--+  +  +--+--+--+--+  +--+  +  +--+--+--+  +  +  +--+  +--+--+  +--+--+  +--+  +--+  +--+  +--+  +  +  +--+  +  +--+  +  +--+  +  +  +
|           |     |  |     |     |     |  |  |              |  |  |     |     |  |  |        |  |     |  |     |  |     |        |  |  |     |  |  |  |
+--+  +--+  +  +--+  +--+  +  +--+--+--+  +--+  +  +  +  +--+--+--+  +  +  +  +--+  +  +--+  +  +  +--+  +--+--+  +--+  +  +--+  +  +--+  +  +  +--+  +
|     |              |     |        |        |  |  |  |  |     |     |     |     |  |  |     |  |     |  |           |  |  |  |        |  |     |     |
+--+  +  +--+--+--+  +  +--+  +  +  +  +--+  +--+  +--+  +  +--+--+  +  +--+--+--+  +  +  +--+  +  +--+  +  +--+--+  +--+  +  +  +--+--+  +--+  +  +--+
|     |        |              |  |  |  |     |        |  |  |  |  |  |  |              |     |     |  |     |              |           |     |  |     |
+--+  +  +--+--+  +--+--+  +--+--+--+  +--+  +  +--+--+--+  +  +  +  +  +  +  +  +--+  +--+--+--+  +  +--+--+  +--+  +--+  +--+  +--+--+--+  +--+--+  +
|     |  |     |  |  |  |        |  |     |  |  |           |     |  |  |  |  |  |           |        |  |  |     |  |        |  |              |     |
+  +--+  +  +--+--+  +  +  +--+--+  +  +--+--+--+  +  +  +--+  +  +--+  +--+--+  +  +  +  +  +  +  +--+  +  +--+--+--+  +--+  +--+  +--+--+  +--+--+  +
|     |  |  |                                |     |  |        |  |  |        |  |  |  |  |  |  |                          |     |     |  |        |  |
+--+  +  +  +  +--+  +--+--+--+--+  +--+--+  +--+--+--+  +--+--+  +  +--+  +  +--+  +  +--+--+--+  +  +--+--+  +--+  +--+--+  +  +  +--+  +  +--+  +--+
|     |  |        |  |     |  |     |     |        |  |     |  |     |     |  |  |  |     |     |  |  |     |     |        |  |  |  |     |     |     |
+  +  +  +  +  +--+--+  +  +  +--+  +  +--+--+--+  +  +--+  +  +  +--+  +--+--+  +--+--+--+  +--+--+  +  +--+--+--+  +--+--+  +--+--+  +--+  +--+  +  +
|  |  |  |  |  |        |                 |     |  |     |     |     |  |        |     |              |     |  |           |     |              |  |  |
+  +--+--+  +--+--+--+--+  +--+  +  +--+  +  +--+--+  +  +  +--+--+--+  +  +  +--+  +--+  +--+  +--+  +  +--+  +  +--+  +  +--+--+--+--+--+  +  +  +  +
|     |     |                 |  |  |     |     |     |        |  |  |     |  |        |  |     |        |  |     |  |  |                 |  |  |  |  |
+--+  +--+--+--+  +--+  +--+--+--+  +--+  +  +  +--+--+  +--+  +  +  +  +--+--+  +--+  +--+--+  +--+--+  +  +  +  +  +  +--+--+--+  +--+  +--+--+--+--+
|        |  |     |  |     |     |  |     |  |  |     |  |     |  |  |              |           |     |     |  |  |     |        |  |  |  |        |  |
+  +--+--+  +--+  +  +--+--+  +  +--+--+  +  +--+  +--+  +--+--+  +  +  +--+  +--+--+--+--+  +--+--+  +  +--+--+--+  +--+  +--+  +  +  +--+--+  +  +  +
|  |  |           |           |           |                    |  |        |  |           |  |     |           |  |  |     |  |     |  |  |     |     |
+  +  +--+  +--+--+--+--+  +--+--+  +  +--+  +  +--+--+--+--+  +  +--+  +--+  +--+--+  +--+--+--+  +--+--+--+  +  +  +  +--+  +  +  +  +  +--+  +  +  +
|        |              |        |  |  |     |  |  |     |     |     |  |           |     |  |     |     |     |     |  |  |     |  |     |     |  |  |
+--+--+--+  +  +--+  +  +--+--+--+--+  +--+  +  +  +  +--+--+  +--+  +--+  +  +--+--+--+  +  +  +--+--+  +  +--+--+  +--+  +  +--+--+--+  +  +  +--+--+
|     |  |  |  |     |  |           |  |  |  |        |     |     |     |  |        |  |  |           |  |  |           |  |  |  |     |     |     |  |
+--+  +  +  +--+--+--+--+--+  +--+--+  +  +  +  +--+--+  +--+  +--+  +  +  +  +--+--+  +  +  +  +--+  +  +--+--+  +--+  +  +  +  +  +--+  +--+  +--+  +
|  |  |                    |  |  |  |        |  |     |  |           |  |  |     |     |     |  |  |              |     |        |        |           |
+  +  +  +  +--+  +  +  +--+  +  +  +  +--+  +--+  +  +  +  +--+  +--+--+  +--+--+--+  +  +--+  +  +--+--+--+  +  +  +  +  +--+--+  +--+--+--+  +--+  +
|        |     |  |  |  |                 |     |  |           |     |           |           |     |           |  |  |  |              |           |   
+--+--+--+--+--+--+--+--+--+--+--+--+--+--+--+--+--+--+--+--+--+--+--+--+--+--+--+--+--+--+--+--+--+--+--+--+--+--+--+--+--+--+--+--+--+--+--+--+--+--+
