15
+--+--+--+--+--+--+--+--+--+--+--+--+--+--+--+
      |  |  |  |        |  |  |              |
+--+  +  +  +  +--+  +--+  +  +--+--+--+--+  +
|     |     |              |              |  |
+  +  +--+  +  +--+  +--+--+  +--+  +--+--+  +
|  |        |  |  |     |     |  |  |     |  |
+  +  +  +  +--+  +  +  +--+  +  +--+--+  +  +
|  |  |  |     |     |  |  |                 |
+--+  +--+  +--+  +--+  +  +--+--+--+  +--+--+
|  |     |     |     |  |                    |
+  +--+  +--+  +--+  +--+--+--+  +  +--+--+  +
|  |        |  |                 |  |  |     |
+  +--+  +  +--+  +  +--+  +--+--+  +  +--+--+
|     |  |        |  |  |  |     |     |     |
+  +--+--+--+--+--+--+  +  +  +--+--+  +  +  +
|  |                 |           |     |  |  |
+  +--+--+  +  +--+--+  +--+--+--+  +  +  +--+
|     |     |     |        |     |  |     |  |
+--+  +--+--+  +--+  +--+  +--+  +--+  +  +  +
|                 |  |     |     |  |  |  |  |
+--+--+--+--+--+  +--+  +--+  +  +  +  +--+  +
|  |  |        |     |  |  |  |              |
+  +  +  +--+--+  +--+--+  +--+  +--+  +--+  +
|                                   |  |  |  |
+--+  +--+  +  +  +--+--+  +  +--+  +--+  +  +
|     |     |  |  |        |  |     |        |
+  +--+  +--+  +--+  +--+  +--+--+--+  +--+  +
|  |     |        |     |           |     |  |
+--+  +--+--+  +--+--+--+--+--+--+--+--+  +--+
|        |                 |                  
+--+--+--+--+--+--+--+--+--+--+--+--+--+--+--+
