11
+--+--+--+--+--+--+--+--+--+--+--+
   |        |  |        |        |
+  +  +--+--+  +--+  +--+--+--+  +
|  |        |  |  |              |
+  +--+--+  +  +  +--+--+  +  +--+
|  |                 |     |     |
+  +  +  +--+  +  +--+  +  +  +  +
|     |     |  |     |  |  |  |  |
+  +  +  +  +--+  +--+--+  +--+--+
|  |  |  |     |           |     |
+  +--+  +--+--+--+--+  +  +  +--+
|  |     |  |  |        |     |  |
+  +--+--+  +  +--+  +  +  +--+  +
|        |           |  |     |  |
+--+  +--+--+  +--+--+--+--+--+  +
|           |           |        |
+  +--+  +  +--+--+--+  +  +  +  +
|  |  |  |        |     |  |  |  |
+--+  +--+  +--+  +--+--+  +  +  +
|           |              |  |  |
+  +  +--+--+--+--+  +--+  +--+  +
|  |        |        |        |   
+--+--+--+--+--+--+--+--+--+--+--+

