5
+--+--+--+--+--+
      |  |     |
+  +  +  +--+  +
|  |     |     |
+--+--+  +--+  +
|           |  |
+  +--+--+  +  +
|  |        |  |
+  +--+  +  +  +
|  |     |      
+--+--+--+--+--+

+--+--+--+--+--+
      |  |     |
+--+  +  +--+  +
|              |
+--+  +--+--+  +
|  |  |        |
+  +  +--+--+  +
|     |        |
+  +  +--+--+  +
|  |     |      
+--+--+--+--+--+