20

+--+--+--+--+--+--+--+--+--+--+--+--+--+--+--+--+--+--+--+--+
         |        |  |        |  |  |  |           |     |  |
+--+--+  +  +--+--+  +--+  +--+  +  +  +  +--+--+--+  +--+  +
|              |     |  |     |              |        |     |
+  +--+--+--+  +  +  +  +  +--+--+--+  +  +  +--+--+  +  +--+
|  |     |        |           |        |  |     |           |
+  +  +--+--+--+  +  +--+--+--+  +--+--+--+--+  +  +--+  +  +
|        |     |  |     |        |        |  |  |     |  |  |
+  +--+  +  +--+  +--+  +--+  +  +--+--+  +  +  +  +  +  +--+
|  |  |  |     |  |  |  |     |  |  |              |  |  |  |
+  +  +  +  +--+--+  +  +  +--+--+  +  +  +  +  +--+--+--+  +
|  |     |                    |     |  |  |  |  |  |  |     |
+  +--+  +  +--+--+  +  +--+--+  +--+--+--+--+--+  +  +  +--+
|  |     |  |  |  |  |  |     |     |     |        |     |  |
+--+--+--+  +  +  +--+  +--+  +  +--+--+  +  +--+  +--+  +  +
|  |  |  |  |        |           |        |     |     |  |  |
+  +  +  +  +  +  +--+--+  +--+--+--+  +--+  +--+--+  +  +  +
|  |           |  |                       |     |  |        |
+  +--+--+  +--+  +  +--+  +  +  +  +  +  +--+  +  +  +--+--+
|           |  |  |  |     |  |  |  |  |  |  |  |  |        |
+--+  +--+--+  +--+--+  +--+--+--+  +--+--+  +  +  +--+  +--+
|                    |  |                       |     |     |
+  +  +--+--+--+--+--+--+--+--+--+  +--+  +  +--+  +  +  +--+
|  |  |     |  |              |  |  |     |  |     |  |     |
+  +  +--+  +  +--+  +  +  +  +  +  +  +--+--+--+  +--+--+  +
|  |           |     |  |  |  |     |     |                 |
+--+--+--+  +--+  +  +  +  +--+--+--+--+--+--+--+  +  +--+--+
|                 |  |  |              |     |  |  |  |     |
+--+  +--+--+--+--+--+--+--+  +--+--+  +  +  +  +--+  +  +  +
|        |     |  |                 |  |  |  |           |  |
+  +--+  +  +--+  +--+  +--+--+--+  +  +  +  +  +--+--+  +--+
|  |  |     |  |     |  |  |  |     |  |  |     |  |     |  |
+  +  +  +--+  +  +--+  +  +  +  +  +  +  +--+  +  +  +--+  +
|  |     |        |           |  |  |  |  |  |  |  |        |
+--+--+  +--+  +--+  +--+--+--+--+--+--+--+  +--+  +--+  +  +
|        |        |           |     |  |           |     |  |
+  +--+  +  +  +--+  +  +--+--+  +--+  +--+--+--+  +--+--+  +
|  |     |  |        |                    |  |     |        |
+  +  +--+--+--+  +--+--+--+  +--+  +--+  +  +  +  +--+  +  +
|  |           |           |  |        |        |  |     |   
+--+--+--+--+--+--+--+--+--+--+--+--+--+--+--+--+--+--+--+--+