10

+--+--+--+--+--+--+--+--+--+--+
            |  |        |  |  |
+--+  +  +--+  +--+  +--+  +  +
|  |  |     |  |           |  |
+  +--+  +  +  +  +  +--+  +  +
|        |     |  |  |        |
+  +--+  +--+  +--+  +--+  +--+
|     |     |  |  |  |     |  |
+--+  +--+--+--+  +  +  +  +  +
|           |        |  |     |
+  +--+  +  +  +--+--+  +--+--+
|  |  |  |  |  |        |     |
+  +  +  +--+--+  +--+  +--+  +
|  |     |        |  |        |
+--+--+  +--+  +--+  +--+--+  +
|  |        |        |        |
+  +--+--+  +  +--+  +--+  +  +
|     |           |     |  |  |
+--+  +  +--+  +  +--+--+--+  +
|           |  |           |   
+--+--+--+--+--+--+--+--+--+--+