5
+--+--+--+--+--+
   |           |
+  +--+--+  +  +
|           |  |
+--+--+  +--+  +
|     |  |     |
+  +--+  +--+  +
|        |     |
+  +--+  +  +  +
|     |  |  |   
+--+--+--+--+--+
