8
+--+--+--+--+--+--+--+--+
   |           |        |
+  +--+  +  +  +--+  +--+
|     |  |  |           |
+--+  +  +--+--+  +  +--+
|  |        |     |     |
+  +--+  +--+--+--+--+  +
|                 |     |
+  +  +--+--+  +  +--+--+
|  |  |        |        |
+--+  +  +--+--+--+  +  +
|     |  |  |        |  |
+--+  +--+  +--+--+--+--+
|     |  |  |     |     |
+  +  +  +  +  +  +  +--+
|  |           |         
+--+--+--+--+--+--+--+--+