20
+--+--+--+--+--+--+--+--+--+--+--+--+--+--+--+--+--+--+--+--+
            |  |                    |  |     |        |  |  |
+--+  +--+  +  +--+--+--+  +--+  +--+  +  +  +--+  +  +  +  +
|        |  |     |  |  |  |  |        |  |        |        |
+--+  +--+--+  +  +  +  +  +  +  +--+--+  +  +--+  +  +--+--+
|              |  |        |     |        |  |     |        |
+  +--+--+  +--+--+--+--+--+  +--+--+--+  +--+--+  +--+--+  +
|     |  |                 |  |              |  |     |     |
+--+  +  +  +--+--+  +--+  +  +  +--+  +  +--+  +--+  +--+--+
|        |     |  |     |           |  |           |  |     |
+  +--+  +--+--+  +--+--+--+  +  +--+--+--+--+--+--+--+  +  +
|     |  |  |        |        |           |              |  |
+  +--+--+  +--+  +--+--+  +--+--+--+  +--+--+  +--+--+--+--+
|  |  |                       |     |        |  |           |
+  +  +--+  +  +--+  +--+--+  +--+  +  +--+--+  +--+  +--+--+
|  |        |  |  |     |     |  |        |     |  |  |     |
+--+--+  +--+--+  +  +--+--+--+  +  +--+  +  +--+  +  +  +--+
|  |  |        |        |  |        |  |  |     |  |        |
+  +  +  +--+--+  +  +--+  +  +--+  +  +--+--+  +  +  +--+  +
|  |           |  |  |  |     |  |  |  |        |     |  |  |
+  +  +--+--+  +--+--+  +--+--+  +  +  +  +  +--+  +--+  +--+
|  |     |     |  |        |  |           |  |  |        |  |
+  +  +--+  +  +  +  +  +--+  +--+  +  +--+--+  +  +--+--+  +
|     |  |  |        |  |     |  |  |           |  |        |
+  +  +  +--+--+--+--+--+  +--+  +--+--+--+  +--+  +  +--+  +
|  |     |        |  |           |     |     |     |     |  |
+  +  +--+  +  +--+  +  +--+  +--+--+  +  +--+  +--+  +  +--+
|  |        |        |     |        |     |           |  |  |
+--+  +--+  +  +--+  +  +--+  +--+  +--+  +--+  +--+--+--+  +
|        |  |  |  |  |     |     |     |  |        |  |     |
+  +  +--+--+--+  +  +  +--+  +--+--+--+  +--+  +--+  +--+  +
|  |        |  |        |  |     |  |     |  |     |        |
+--+  +--+  +  +--+  +--+  +--+--+  +--+  +  +--+  +  +  +  +
|        |  |        |        |     |           |     |  |  |
+--+--+--+  +  +--+  +  +  +--+  +--+--+  +--+  +  +  +--+  +
|           |  |  |  |  |  |  |     |  |  |        |     |  |
+--+--+  +--+  +  +  +  +--+  +  +  +  +  +--+  +--+  +  +  +
|           |     |     |  |     |        |  |     |  |  |  |
+  +--+  +  +--+  +  +--+  +  +--+--+--+  +  +--+  +--+  +  +
|     |  |  |     |     |     |              |        |  |   
+--+--+--+--+--+--+--+--+--+--+--+--+--+--+--+--+--+--+--+--+