5
+--+--+--+--+--+
            |  |
+--+  +--+  +  +
|     |  |  |  |
+--+  +  +  +  +
|  |     |     |
+  +  +--+--+  +
|  |  |        |
+  +  +  +  +  +
|     |  |  |   
+--+--+--+--+--+

20
+--+--+--+--+--+--+--+--+--+--+--+--+--+--+--+--+--+--+--+--+
      |  |        |     |              |  |           |     |
+--+  +  +--+--+  +  +--+--+  +--+--+  +  +  +--+--+  +  +--+
|     |     |                 |        |  |     |  |  |  |  |
+  +  +  +  +  +--+  +--+  +--+  +--+  +  +  +--+  +  +  +  +
|  |  |  |        |     |  |     |        |  |        |  |  |
+--+  +  +  +--+  +  +--+  +  +  +--+--+  +  +--+--+--+  +  +
|  |     |  |  |  |  |     |  |  |     |                    |
+  +--+  +--+  +--+  +--+  +  +--+  +  +  +  +--+  +--+  +--+
|                 |  |     |  |  |  |     |  |        |     |
+--+  +--+--+--+--+--+--+--+  +  +--+--+--+  +--+--+  +--+  +
|  |     |  |     |  |        |                    |     |  |
+  +  +--+  +  +--+  +--+  +  +--+--+--+--+  +  +--+--+--+  +
|     |           |        |     |           |  |        |  |
+--+  +  +--+  +--+--+--+  +--+--+--+  +  +--+--+  +--+--+  +
|     |  |     |     |     |  |        |                 |  |
+  +--+--+  +--+  +--+--+  +  +--+--+  +--+--+  +--+  +--+--+
|              |     |  |     |        |     |     |  |     |
+--+  +  +--+  +--+  +  +--+  +  +--+--+--+  +  +--+  +--+  +
|     |  |     |        |  |  |              |  |  |        |
+  +--+--+  +--+--+--+  +  +  +--+  +--+  +--+--+  +--+--+--+
|  |     |  |     |     |     |  |  |  |  |  |  |     |     |
+--+--+  +  +--+  +--+  +  +--+  +  +  +--+  +  +--+  +--+  +
|              |           |                 |     |        |
+  +--+  +  +--+  +--+  +  +--+  +--+--+--+  +  +  +  +--+--+
|     |  |  |     |     |  |     |           |  |           |
+  +--+  +--+  +  +--+  +--+--+--+--+--+  +--+--+  +--+--+  +
|     |     |  |     |              |                    |  |
+--+--+--+  +--+--+--+--+  +--+--+  +--+--+--+  +--+--+--+--+
|           |        |           |           |  |     |     |
+  +--+--+--+--+  +  +  +  +  +  +--+  +--+  +--+--+  +--+  +
|        |     |  |     |  |  |  |     |           |  |     |
+  +  +  +--+  +--+--+--+  +--+  +--+--+--+--+--+  +  +  +  +
|  |  |     |  |              |           |  |     |  |  |  |
+--+  +--+--+  +  +--+--+--+--+--+--+--+  +  +--+--+  +--+  +
|     |  |        |                 |                       |
+  +  +  +  +  +--+--+--+--+  +--+  +--+  +--+  +  +  +  +  +
|  |  |     |        |        |           |     |  |  |  |  |
+  +  +--+--+  +  +  +  +--+--+  +--+  +--+  +--+  +--+--+  +
|  |  |        |  |  |        |  |        |     |     |      
+--+--+--+--+--+--+--+--+--+--+--+--+--+--+--+--+--+--+--+--+