4
+--+--+--+--+
   |  |     |
+  +  +  +--+
|  |        |
+  +--+  +  +
|        |  |
+--+  +  +--+
|     |      
+--+--+--+--+

