n = 10

+--+--+--+--+--+--+--+--+--+--+
         |  |     |           |
+  +--+  +  +--+  +--+--+  +--+
|  |  |  |  |        |        |
+  +  +--+  +--+  +--+  +  +--+
|        |     |        |     |
+  +--+  +  +--+--+  +--+--+  +
|  |                 |  |     |
+--+  +--+--+  +  +--+  +--+  +
|  |  |     |  |  |  |  |     |
+  +  +--+  +--+--+  +  +--+  +
|     |                    |  |
+--+--+--+--+--+  +  +--+  +  +
|        |  |  |  |  |        |
+--+  +--+  +  +  +--+--+--+  +
|  |              |     |     |
+  +--+  +  +  +--+--+  +--+  +
|        |  |     |           |
+  +--+  +--+--+  +--+--+  +  +
|     |  |              |  |   
+--+--+--+--+--+--+--+--+--+--+
